regional arrays? Europe, South Asia, East Asia, Canada, US, Central America, South America, Australia
just put them in as lowercase strings so they can be popped right into a http request
so, need a method that iterates through each country periodically (every 3 hrs, let's say), and writes
the data to its .json data file

AD - andorra (wu has a pws, can't find it on aeris)
AE - united arab emirates (9 stations) (wu - er)
AF - afghanistan (8 stations) (wu - ah)
AG - antigua and barbuda (2 stations) (wu - at)
AI - anguilla (0 stations) (wu - a1)
AL - albania (1 station) (wu - ab)
AM - armenia (2 stations)
AO - angola (3) (wu - an)
AQ - antarctica (4) (wu - aa)
AR - argentina (23) (wu - ag)
AS - american samoa (0)
AT - austria (7) (wu - os)
AU - australia (95)
AW - aruba (1)
AX - aland islands (0)
AZ - azerbaijan (6) (wu - a2)
BA - bosnia and herzegovina (1) 
BB - barbados (1) (wu - br)
BD - bangladesh (2) (wu - bw)
BE - belgium (12) (wu - bx)
BF - burkina faso (3) (wu - hv)
BG - bulgaria (4) (wu - bu)
BH - bahrain (1) (wu - bn)
BI - burundi (0)
BJ - benin (1)
BL - saint barthelemy (0)
BM - bermuda (1) (wu - be)
BN - brunei darussalam (0) (wu - bf)
BO - bolivia (24)
BQ - bonaire, sint eustatius and saba (0)
BR - brazil (124) (wu - bz)
BS - bahamas (4)
BT - bhutan (1) (wu - b2)
BV - bouvet island (0)
BW - botswana (5) (wu - bc)
BY - belarus (4)
BZ - belize (1) (wu - bh)
CA - canada (see directory)
CC - cocos (keeling) islands (0)
CD - democratic republic of the congo (0)
CF - central african republic (1) (wu - ce)
CG - congo (2)
CH - switzerland (16) (wu - sw)
CI - cote d'ivoire (1) (wu - iv)
CK - cook islands (0) (wu - ku)
CL - chile (15) (wu - ch)
CM - cameroon (3)
CN - china (37) (wu - ci)
CO - colombia (29)
CR - costa rica (4) (wu - cs)
CU - cuba (10)
CV - cabo verde (3)
CW - curacao (0)
CX - christmas island (0)
CY - cyprus (4)
CZ - czech republic (9)
DE - germany (76) (wu - dl)
DJ - djibouti (2)
DK - denmark (16) (wu - dn)
DM - dominica (2) (wu - do)
DO - dominican republic (9) (wu - dr)
DZ - algeria (30) (wu - al)
EC - ecuador (4) (wu - eq)
EE - estonia (4)
EG - egypt (13)
EH - western sahara (0)
ER - eritrea (0) - i checked asmara on wu and there were current conditions but said the station was offline, so could be old conditions (wu - e1)
ES - spain (37) (wu - sp)
ET - ethiopia (1)
FI - finland (27)
FJ - fiji (6)
FK - falkland islands (malvinas) (1)
FM - federated states of micronesia (9) (wu us_fm)
FO - faroe islands (0) (wu - fa)
FR - france (99) - just tried it again and got (102)!
GA - gabon (2) (wu - go)
GB - united kingdom (81) (wu - uk)
GD - grenada (1)
GE - georgia (3)
GF - french guiana (0) (wu - fg)
GG - guernsey (0)
GH - ghana (1)
GI - gibraltar (1)
GL - greenland (6)
GM - gambia (1) (wu - gb)
GN - guinea (1)
GP - guadeloupe (1)
GQ - equatorial guinea (2)
GR - greece (27)
GS - south georgia and the south sandwich islands (0)
GT - guatemala (10) (wu - gu)
GU - guam (0)
GW - guinea-bissau (0)
GY - guyana (3)
HK - hong kong (1)
HM - heard island and mcdonald islands (0)
HN - honduras (15)
HR - croatia (7)
HT - haiti (0)
HU - hungary ()
ID - indonesia
IE - ireland
IL - israel
IM - isle of man
IN - india
IO - british indian ocean territory
IQ - iraq
IR - islamic republic of iran
IS - iceland
IT - italy (84)
JE - jersey
JM - jamaica
JO - jordan
JP - japan
KE - kenya
KG - kyrgyzstan
KH - cambodia
KI - kiribati
KM - comoros
KN - saint kitts and nevis
KP - democratic people's republic of korea (north korea)
KR - republic of korea (south korea)
KW - kuwait
KY - cayman islands
KZ - kazakhstan
LA - lao people's democratic republic (laos)
LB - lebanon
LC - saint lucia
LI - liechtenstein*
LK - sri lanka
LR - liberia
LS - lesotho
LT - lithuania
LU - luxembourg
LV - latvia
LY - libya
MA - morocco
MC - monaco
MD - republic of moldova
ME - montenegro
MF - saint martin (french)
MG - madagascar
MH - marshall islands
MK - macedonia
ML - mali
MM - myanmar
MN - mongolia
MO - macao
MP - northern mariana islands
MQ - martinique
MR - mauritania
MS - montserrat
MT - malta
MU - mauritius
MV - maldives
MW - malawi
MX - mexico
MY - malaysia
MZ - mozambique
NA - namibia
NC - new caledonia
NE - niger
NF - norfolk island
NG - nigeria
NI - nicaragua
NL - netherlands
NO - norway
NP - nepal
NR - nauru
NU - niue
NZ - new zealand
OM - oman
PA - panama
PE - peru
PF - french polynesia
PG - papua new guinea
PH - philippines
PK - pakistan
PL - poland
PM - saint pierre and miquelon
PN - pitcairn
PR - puerto rico
PS - state of palestine
PT - portugal
PW - palau
PY - paraguay
QA - qatar
RE - reunion
RO - romania
RS - serbia
RU - russian federation
RW - rwanda
SA - saudi arabia
SB - solomon islands
SC - seychelles
SD - sudan
SE - sweden
SG - singapore
SH - saint helena, ascension and tristan da cunha
SI - slovenia
SJ - svalbard and jan mayen
SK - slovakia
SL - sierra leone
SM - san marino
SN - senegal
SO - somalia
SR - suriname
SS - south sudan
ST - sao tome and principe
SV - el salvador
SX - sint maarten (dutch)
SY - syrian arab republic
SZ - swaziland
TC - turks and caicos islands
TD - chad
TF - french southern territories
TG - togo
TH - thailand
TJ - tajikistan
TK - tokelau
TL - timor - leste
TM - turkmenistan
TN - tunisia
TO - tonga
TR - turkey
TT - trinidad and tobago
TV - tuvalu
TW - taiwan, province of china
TZ - united republic of tanzania
UA - ukraine
UG - uganda
UM - united states minor outlying islands (wake island)
US - united states
UY - uruguay
UZ - uzbekistan
VA - holy see (vatican city state)
VC - saint vincent and the grenadines
VE - venezuela
VG - british virgin islands
VI - u.s. virgin islands
VN - viet nam
VU - vanuatu
WF - wallis and futuna
WS - samoa
XK - temporary code for kosovo
YE - yemen
YT - mayotte
ZA - south africa
ZM - zambia
ZW - zimbabwe